Словарь: English
Дата создания: 02.10.2025 22:29:28
Дата последнего изменения: 02.10.2025 22:29:28
Слова:
----------------------------------------
Home - Дом
Road - Дорога
Time - Время
Person - Человек
Year - Год
Day - День
Thing - Вещь
Man - Мужчина
World - Мир
Life - Жизнь
Hand - Рука
Part - Часть
Child - Ребенок
Eye - Глаз
Woman - Женщина
Place - Место
Work - Работа
Week - Неделя
Case - Случай
Point - Точка
Government - Правительство
Company - Компания
Number - Число
Group - Группа
Problem - Проблема
Fact - Факт
Water - Вода
Room - Комната
Mother - Мать
Area - Область
Money - Деньги
Story - История
Month - Месяц
Right - Право
Study - Учеба
Book - Книга
Job - Работа
Word - Слово
Business - Бизнес
Issue - Вопрос
Side - Сторона
Kind - Вид
Head - Голова
House - Дом
Service - Услуга
Friend - Друг
Father - Отец
Power - Сила
Hour - Час
Game - Игра
Line - Линия
End - Конец
Member - Член
Law - Закон
Car - Машина
City - Город
Name - Имя
Team - Команда
Minute - Минута
Idea - Идея
Kid - Ребенок
Body - Тело
Information - Информация
Back - Спина
Parent - Родитель
Face - Лицо
Level - Уровень
Office - Офис
Door - Дверь
Health - Здоровье
Art - Искусство
War - Война
History - История
Party - Вечеринка
Result - Результат
Change - Изменение
Morning - Утро
Reason - Причина
Research - Исследование
Food - Еда
Moment - Момент
Air - Воздух
Teacher - Учитель
Education - Образование
Foot - Нога
Boy - Мальчик
Age - Возраст
Policy - Политика
Music - Музыка
Market - Рынок
Sense - Чувство
Nation - Нация
Plan - План
Death - Смерть
Action - Действие
Love - Любовь
System - Система
Sun - Солнце
Question - Вопрос
School - Школа
----------------------------------------
Всего слов: 100
