Словарь: Russian
Дата создания: 05.10.2025 18:01:35
Дата последнего изменения: 05.10.2025 18:01:35
Слова:
----------------------------------------
Дом - Home
Дорога - Road
Время - Time
Человек - Person
Год - Year
День - Day
Вещь - Thing
Мужчина - Man
Мир - World
Жизнь - Life
Рука - Hand
Часть - Part
Ребенок - Child
Глаз - Eye
Женщина - Woman
Место - Place
Работа - Work
Неделя - Week
Случай - Case
Точка - Point
Правительство - Government
Компания - Company
Число - Number
Группа - Group
Проблема - Problem
Факт - Fact
Вода - Water
Комната - Room
Мама - Mother, Mom
Область - Area
Деньги - Money
История - Story
Месяц - Month
Право - Right
Учеба - Study
Книга - Book
Работа - Job
Слово - Word
Бизнес - Business
Вопрос - Question
Сторона - Side
Вид - Kind
Голова - Head
Дом - House
Услуга - Service
Друг - Friend
Отец - Father
Сила - Power
Час - Hour
Игра - Game
Линия - Line
Конец - End
Член - Member
Закон - Law
Машина - Car
Город - City
Имя - Name
Команда - Team
Минута - Minute
Идея - Idea
Ребенок - Kid
Тело - Body
Информация - Information
Спина - Back
Родитель - Parent
Лицо - Face
Уровень - Level
Офис - Office
Дверь - Door
Здоровье - Health
Искусство - Art
Война - War
История - History
Вечеринка - Party
Результат - Result
Изменение - Change
Утро - Morning
Причина - Reason
Исследование - Research
Еда - Food
Момент - Moment
Воздух - Air
Учитель - Teacher
Образование - Education
Нога - Foot
Мальчик - Boy
Возраст - Age
Политика - Policy
Музыка - Music
Рынок - Market
Чувство - Feeling
Нация - Nation
План - Plan
Смерть - Death
Действие - Action
Любовь - Love
Система - System
Солнце - Sun
Вопрос - Issue
Школа - School
----------------------------------------
Всего слов: 100
